NO ./imgs/wooden_wall_chopper.png
SO ./imgs/wooden_wall_nami.png
EA ./imgs/wooden_wall_monkey.png
WE ./imgs/wooden_wall_nico.png

DO ./imgs/wooden-wall_door.png
C 9, 24, 51
F 48, 27, 104

111111111111111111111111111
100000000000000000000000001
111111111111111111111000001
100000000000000000000000001
110000000011111111111111111
100000000000000000000000001
100000000000000000000000001
100000000000000000000000001
111111111111111110000000011
100000000000000000000000001
100000000000000000000000001
100000000000000000000000001
100000000000000000000000001
111111111111D11111111111111
100000000000000000000000001
100000000000000000000000001
100000000000N00000000000001
100000000000000000000000001
100000000000000000000000001
111111111111111111111111111