NO ./imgs/wooden-wall_2_colt.png
SO ./imgs/wooden-wall_2_native_american.png
EA ./imgs/wooden-wall_2_derringer.png
WE ./imgs/wooden-wall_2_winchester.png

DO ./imgs/wooden-wall_door.png
C 9, 24, 51
F 48, 27, 104

111111111111
100000000001
100010011101
1000D0000101
1011100S1101
100000000001
111111111111