NO ./imgs/malaca_04.png
SO ./imgs/malaca_01.png
EA ./imgs/malaca_03.png
WE ./imgs/malaca_02.png

DO ./imgs/malaca_dog.png
C 9, 24, 51
F 48, 27, 104

111111111111
100000000001
100010011101
100000000101
101110001101
100000000001
111111D01111
1000000011
100011111
10S01
11111