NO ./imgs/wall_04.png
SO ./imgs/wall_01.png
EA ./imgs/wall_03.png
WE ./imgs/wall_02.png

DO ./imgs/wall_door.png
C 105, 105, 105
F 127, 127, 127

111111111111111111111111111
100000000000000000000000001
100000000000000000000000001
100000000000000000000000001
11111011111011111011111011111111111111111111111
10000000000000000000000000000000000000000000001
10001110001110001110001110001110001110001110001
10000000000000000000000000000000000000000000001
1111111111111D111111111111111111111111111111111
100000000000000000000000001
100000000000000000000000001
1000000000000S0000000000001
100000000000000000000000001
100000000000000000000000001
111111111111111111111111111