NO ./imgs/wooden_wall_chopper.png
SO ./imgs/wooden_wall_nami.png
EA ./imgs/wooden_wall_monkey.png
WE ./imgs/wooden_wall_nico.png

C 9, 24, 51
F 48, 27, 104

111111111111
100000000001
1010001101101111111111
1010010000000000000001
1000111110000000000001
1000000000000000000001
1001111110000000000001
1000000000N01111111111
111111111111