111111111111111111111111111111111111111111111111111111111111
1C0000CCCC000000000C000000C1111111000000X0CCC0000C0000X00C11
10001010000000X1C0011000010000X0000000100000000001C110000111
100010100100000100011C00010000000111000100100000011111000001
1P0X1E10X00X000CCC0100XC000011C11CCCC11CCCCC1110000X00000001
1C000XCCCC010000000C0000X0011111110000000000C0110C0001X00C11
1X00101000000X01C001100X010000X00000001C00000001101110000111
1C0000C1CC010100000C0000100110C11100000000CC10000C0000X00011
1X00101000010011C00110000100000000000X1X000011000110100C0001
1C0XC00CCC0000C1000C00C0000111111100000000CXC0000CX000X00011
1000101000110001C00110000100001C000000100C00011100111001C111
111111111111111111111111111111111111111111111111111111111111