111111111111111111111
1C0000CCCC0X0000000C1
1X0X1010X0000X01C0X11
1P001E10000X000CCCC01
111111111111111111111