1111111111111111111111111111111111
1E0X0000000000XC00000C00000X000001
101001010010000010100100X000010101
1010010010101010001X010000X0010101
1P00X000XC0XC000X000000X000000CXC1
1111111111111111111111111111111111
