111111111111111111111
100000P0000000000000
100C0000000000C000001
1E0000000000000C00001
111111111111111111111